.................
.................
.................
........#........
........#........
........#........
........#........
.................
.....#...........
.....#...........
.....#...........
.................
........#........
........#........
#################

